NO     textures/east1.xpm

C    textures/c.xpm
F     textures/f.xpm

WE      textures/west1.xpm

EA    textures/west1.xpm
SO       textures/east1.xpm

111111111111111111111111111111111111111111111
100000100000100010000100001100001000100100001
100000000000100000000100000000001000100100001
100111211100100101001100111121111000000100001
110111011100100101001100111000111111000200001
100111011100100121001100001000000000000111211
100200000200200002002000111211112111111200001
10011101110010N001001100000001100002000110001
110111011100100111111100010000000011000200001
100111211100100002000011121111112111111111211
100000000000000001100000000000000000000110001
100000110000000000000000000110000000000000001
111121111112111211121111211111211121111112111
100000100000100010000100001100001000100100001
100000000000100000000100000000001000100100001
100111211100100101001100111121111000000100001
110111011100100101001100111000111111000200001
100111011100100121001100001000000000000111211
100200000200200002002000111211112111111200001
100111011100100001001100000001100002000110001
110111011100100111111100010000000011000200001
100111211100100002000011121111112111111111211
100000000000000001100000000000000000000110001
100000110000000000000000000110000000000000001
111111111111111111111111111111111111111111111