NO     textures/1.xpm

C    255,219,164
F     98,104,105

WE      textures/4.xpm

EA    textures/2.xpm
SO       textures/3.xpm

11111111111111111111111
10000000000000000000001
10011001111001111001001
10000000000000000000001
10011011011000010110001
10011010001000000000001
10000000000000010010001
10110010001000000000001
10110011011000010110001
10000000000000010010001
10000001110011000010001
10011011000000001000001
1000001000N000001110001
10000000000000000000001
10101010000100010001001
10000000000101010001001
11111111100101010001001
11010000100000000001101
11000010100100010000001
11010000100100010001101
11011111100000000001001
11000000001100011101001
11111111100001000000001
11111111111111111111111